10 10
0 0
0 1 1 1 1 1 1 1 1 2
3 9 9 9 9 9 9 9 9 4
3 9 8 8 9 9 8 8 9 4
3 9 8 9 9 9 9 8 9 4
3 9 9 9 8 8 9 9 9 4
3 9 9 9 8 8 9 9 9 4
3 9 8 9 9 9 9 8 9 4
3 9 8 8 9 9 8 8 9 4
3 9 9 9 9 9 9 9 9 4
5 6 6 6 6 6 6 6 6 7